start time ,tail call end time ,syscall end time ,time to run tail calls ,time to run syscall ,total time to run
15802541631093 ,15802541673240 ,15802542869122 ,42147 ,1195882 ,1238029
15802557335951 ,15802557346487 ,15802557774252 ,10536 ,427765 ,438301
15802572713749 ,15802572740797 ,15802573596942 ,27048 ,856145 ,883193
15802591092699 ,15802591125117 ,15802591904169 ,32418 ,779052 ,811470
15802609021165 ,15802609029345 ,15802609345126 ,8180 ,315781 ,323961
15802621894530 ,15802621909308 ,15802622542284 ,14778 ,632976 ,647754
15802639265553 ,15802639297182 ,15802640063284 ,31629 ,766102 ,797731
15802655395515 ,15802655408818 ,15802655894547 ,13303 ,485729 ,499032
15802674462051 ,15802674485025 ,15802674987174 ,22974 ,502149 ,525123
15802686862298 ,15802686871273 ,15802687302184 ,8975 ,430911 ,439886
15802703081089 ,15802703089901 ,15802703430789 ,8812 ,340888 ,349700
15802719481217 ,15802719516446 ,15802720285088 ,35229 ,768642 ,803871
15802736129613 ,15802736153787 ,15802736935534 ,24174 ,781747 ,805921
15802751105983 ,15802751146088 ,15802751908900 ,40105 ,762812 ,802917
15802766768834 ,15802766783126 ,15802767124297 ,14292 ,341171 ,355463
15802784974133 ,15802785013033 ,15802785673353 ,38900 ,660320 ,699220
15802802705955 ,15802802714473 ,15802803048137 ,8518 ,333664 ,342182
15802815419655 ,15802815429025 ,15802816117134 ,9370 ,688109 ,697479
15802835780102 ,15802835818453 ,15802836534326 ,38351 ,715873 ,754224
15802854779619 ,15802854788449 ,15802855548844 ,8830 ,760395 ,769225
15802870482038 ,15802870492227 ,15802871480404 ,10189 ,988177 ,998366
15802885754875 ,15802885772514 ,15802886881742 ,17639 ,1109228 ,1126867
15802903237850 ,15802903259298 ,15802903779177 ,21448 ,519879 ,541327
15802916681987 ,15802916696112 ,15802917073995 ,14125 ,377883 ,392008
15802931628640 ,15802931639594 ,15802932081719 ,10954 ,442125 ,453079
15802946187438 ,15802946264770 ,15802946777881 ,77332 ,513111 ,590443
15802959499817 ,15802959514911 ,15802959865095 ,15094 ,350184 ,365278
15802973371281 ,15802973402201 ,15802974167986 ,30920 ,765785 ,796705
15802993033539 ,15802993052426 ,15802993445795 ,18887 ,393369 ,412256
15803006586982 ,15803006601179 ,15803006932720 ,14197 ,331541 ,345738
15803020791436 ,15803020802274 ,15803021172820 ,10838 ,370546 ,381384
15803041220925 ,15803041242774 ,15803041926803 ,21849 ,684029 ,705878
15803055975513 ,15803055993723 ,15803056721470 ,18210 ,727747 ,745957
15803069721302 ,15803069729423 ,15803070058486 ,8121 ,329063 ,337184
15803087142044 ,15803087192706 ,15803087637792 ,50662 ,445086 ,495748
15803103149419 ,15803103202755 ,15803103656798 ,53336 ,454043 ,507379
15803123655882 ,15803123674145 ,15803125063077 ,18263 ,1388932 ,1407195
15803147235351 ,15803147264459 ,15803148271041 ,29108 ,1006582 ,1035690
15803163390084 ,15803163437763 ,15803164191184 ,47679 ,753421 ,801100
15803176541210 ,15803176553104 ,15803176877070 ,11894 ,323966 ,335860
15803188735823 ,15803188769969 ,15803189193150 ,34146 ,423181 ,457327
15803207536504 ,15803207553522 ,15803208161344 ,17018 ,607822 ,624840
15803221154178 ,15803221163221 ,15803221518800 ,9043 ,355579 ,364622
15803235292436 ,15803235305481 ,15803235822011 ,13045 ,516530 ,529575
15803249213619 ,15803249228420 ,15803249909393 ,14801 ,680973 ,695774
15803269666894 ,15803269679504 ,15803270571753 ,12610 ,892249 ,904859
15803285974449 ,15803286000797 ,15803286567744 ,26348 ,566947 ,593295
15803298470099 ,15803298509946 ,15803299451191 ,39847 ,941245 ,981092
15803326308800 ,15803326319030 ,15803326683285 ,10230 ,364255 ,374485
15803340647961 ,15803340687311 ,15803341091508 ,39350 ,404197 ,443547
15803354963296 ,15803354998378 ,15803355901440 ,35082 ,903062 ,938144
15803375602257 ,15803375614897 ,15803376212408 ,12640 ,597511 ,610151
15803389630168 ,15803389640511 ,15803389990658 ,10343 ,350147 ,360490
15803405061948 ,15803405094803 ,15803405984698 ,32855 ,889895 ,922750
15803423023542 ,15803423032613 ,15803423361146 ,9071 ,328533 ,337604
15803437829720 ,15803437913557 ,15803438565739 ,83837 ,652182 ,736019
15803453585585 ,15803453595182 ,15803453892438 ,9597 ,297256 ,306853
15803469598305 ,15803469607928 ,15803469880570 ,9623 ,272642 ,282265
15803489019969 ,15803489039628 ,15803489708555 ,19659 ,668927 ,688586
15803501219567 ,15803501230901 ,15803501709865 ,11334 ,478964 ,490298
15803514937641 ,15803514982916 ,15803515442414 ,45275 ,459498 ,504773
15803531251735 ,15803531280270 ,15803531794568 ,28535 ,514298 ,542833
15803555729460 ,15803555808828 ,15803556961475 ,79368 ,1152647 ,1232015
15803576471229 ,15803576487139 ,15803576949971 ,15910 ,462832 ,478742
15803591582180 ,15803591623769 ,15803592685139 ,41589 ,1061370 ,1102959
15803611638557 ,15803611677845 ,15803613061815 ,39288 ,1383970 ,1423258
15803629196137 ,15803629209561 ,15803629738517 ,13424 ,528956 ,542380
15803643093314 ,15803643104220 ,15803643421558 ,10906 ,317338 ,328244
15803657844191 ,15803657862970 ,15803658819684 ,18779 ,956714 ,975493
15803686955642 ,15803686965159 ,15803687265997 ,9517 ,300838 ,310355
15803700183500 ,15803700193964 ,15803700673823 ,10464 ,479859 ,490323
15803713514012 ,15803713552026 ,15803714597044 ,38014 ,1045018 ,1083032
15803732417305 ,15803732430719 ,15803733819767 ,13414 ,1389048 ,1402462
15803750782387 ,15803750797911 ,15803751527057 ,15524 ,729146 ,744670
15803764983084 ,15803764993966 ,15803765348411 ,10882 ,354445 ,365327
15803781607312 ,15803781620989 ,15803783200392 ,13677 ,1579403 ,1593080
15803798585036 ,15803798593921 ,15803799117715 ,8885 ,523794 ,532679
15803812852077 ,15803812873601 ,15803813485237 ,21524 ,611636 ,633160
15803827831983 ,15803827840664 ,15803828424351 ,8681 ,583687 ,592368
15803848817757 ,15803848827708 ,15803849280547 ,9951 ,452839 ,462790
15803863900791 ,15803863960999 ,15803864685881 ,60208 ,724882 ,785090
15803877245261 ,15803877256234 ,15803877669664 ,10973 ,413430 ,424403
15803891833151 ,15803891853554 ,15803892851754 ,20403 ,998200 ,1018603
15803912557440 ,15803912601680 ,15803913280918 ,44240 ,679238 ,723478
15803926939565 ,15803926948307 ,15803927265466 ,8742 ,317159 ,325901
15803940312373 ,15803940325498 ,15803940662136 ,13125 ,336638 ,349763
15803957418114 ,15803957435068 ,15803957874760 ,16954 ,439692 ,456646
15803970521668 ,15803970531456 ,15803970846025 ,9788 ,314569 ,324357
15803984921942 ,15803984959626 ,15803985347385 ,37684 ,387759 ,425443
15803998289335 ,15803998301199 ,15803999309874 ,11864 ,1008675 ,1020539
15804017659984 ,15804017673320 ,15804018212316 ,13336 ,538996 ,552332
15804031612463 ,15804031623303 ,15804031981755 ,10840 ,358452 ,369292
15804047060357 ,15804047078520 ,15804047645944 ,18163 ,567424 ,585587
15804062294250 ,15804062307169 ,15804062882047 ,12919 ,574878 ,587797
15804075598378 ,15804075626749 ,15804076047701 ,28371 ,420952 ,449323
15804091010021 ,15804091019340 ,15804091636030 ,9319 ,616690 ,626009
15804105292618 ,15804105313198 ,15804105639746 ,20580 ,326548 ,347128
15804119912714 ,15804119958132 ,15804120383225 ,45418 ,425093 ,470511
15804136336574 ,15804136365569 ,15804136805281 ,28995 ,439712 ,468707
15804149201967 ,15804149211442 ,15804149513559 ,9475 ,302117 ,311592
